---------------------------------------------------------------------------------------------------------------------------------------------------------------------------------------------------------
---------------------------------------------------------------------------------------------------------------------------------------------------------------------------------------------------------
---------------------------------------------------------------------------------------------------------------------------------------------------------------------------------------------------------
---------------------------------------------------------------------------------------------------------------------------------------------------------------------------------------------------------
---------------------------------------------------------------------------------------------------------------------------------------------------------------------------------------------------------
----BB------?---------------------------B------------------------?-------------------------------------B--------------------B?B--------------------o-B------------------B--------------------------------
-------------------B---------------------------------------------?-------BB----------------B-------------------------o---??---------------------------------------?----?---------------------------------
---------------------------------------------------------------B-B?B-----------o-----------------------?----------?-B----------------------------------------------------------------------------------v-
-----------------------------------------------------------------------------B-----------------------------------------?--------B-------------------------------?----o---------------------B-----------f-
----------?B------------------------------?---------------BB-------?-------BB?--------Bo---------------------------------------------------------------------B-------------o----------------B----------f-
--------------o--------o------------------------------------o----------------------------B--------------o---------?------------------------B------B----------------------------------------------------f-
------------o---------------------------------------------oo-------------------o-----------------------------------------------------------------------------------o-----------------------------------f-
-T--------------T-----T---T-----------------------o------T-------------------------o--------------------------------------------T---------T-----T----------------------------------T---------------T---f-
-|--------------|-----|---|--T---T--T--------------------|-----------------------------------T------------------------o--------T|---T-----|-----|--------------T-------------------|---------------|--Tf-
m|--------------|-----|---|--|---|--|--------------------|----EE-----------------------------|-E----------E--------------------||-E-|-----|-----|--------E-----|------------------E|-----E---------|--|--
XXXXXXXXXXXXXXXXXXXXXXXXXXXXXXXXXXXXXXXXX--XXXXXXXXXXXXXXXXXXXXXXXXXXXXXXXXXXXXXXXXXXXXXXXXXXXXXXXXXX--XXXXXXXXXXXXXXXXXXXXXXXXXXXXXXXXXXXXXXXXXXXXXXXXXXXXXXXXXXXXXXXXXXXX--XXXXXXXXXXXXXXXXXX--XXXXXXX-
