---------------------------------------------------------------------------------------------------------------------------------------------------------------------------------------------------------
---------------------------------------------------------------------------------------------------------------------------------------------------------------------------------------------------------
---------------------------------------------------------------------------------------------------------------------------------------------------------------------------------------------------------
---------------------------------------------------------------------------------------------------------------------------------------------------------------------------------------------------------
---------------------------------------------------------------------------------------------------------------------------------------------------------------------------------------------------------
-----------------------------------------------------B-------?-------------?------------------B----------B-----------------------------------------------------------------------------------B-----------
----------o---------?---------------------------------------------------------o-------B-----------------------------------------------------------?-B---------o--B--------------------?------------------
-------------------------------B-B?B---------------B------------??B------------------------------------------?-?-------?----------------------------------------------?---------------------B----------v-
-----------------------------------------------------------------------------------B-------------------------------------------------------------------------------------------------------------------f-
------------B--------------------------------------B?B---B----------B----------------------B--------------------------------------------------------------------------------------?------------------B-f-
---o---------------o--------B--------------B------------------------------------------------o--?--------------------?--------------------------------?---------B------B??-------B----------------------f-
-------------------------------o---------o-------o--------------------------------------------------------------------------------------------------------------------------o--------o-----------o---o-f-
-------TTT---T------o--------T------------T-T---------T-------TT----------------T---oT--o-----------------T-------------T------T-T---------T-T-T-------o------------------------------o-------To-------f-
-----T-|||---|-----T----o-o--|T---------o-|-|---T-----|---TT--||----------------|---T|---------------T----|-------------|------|-|--T--T---|-|-|------------------------------T---------------|--------f-
m----|-|||---|-----|---------||-----------|-|---|-----|-E-||--||----------------|E--||-------E-------|----|-----E-------|------|-|--|-E|---|-|-|--------E-E----E--------------|------------E--|----------
XXXXXXXXXXXXXXXXXXXXXXXXXXXXXXXXXXXXXXXXXXXXXXXXXXX--XXXXXXXX--XXXXXXXXXXXXXXXXXX--XXXXXXXXXXXXXXXXXXXXXXXXXXXXXXXXXXXXXXXXXXXXXXXX--XXXXXXXXXXXXXXXXXX--XXXXXXXXXXXXXXXXXXXXXXXXXXXXXXXXXXXXXX--XXXXXXX-
