---------------------------------------------------------------------------------------------------------------------------------------------------------------------------------------------------------
---------------------------------------------------------------------------------------------------------------------------------------------------------------------------------------------------------
---------------------------------------------------------------------------------------------------------------------------------------------------------------------------------------------------------
---------------------------------------------------------------------------------------------------------------------------------------------------------------------------------------------------------
---------------------------------------------------------------------------------------------------------------------------------------------------------------------------------------------------------
-------------------------------------------------BBB---------------o------------------------------B------o----------------------------B---B---------------------------?-B-B-------------B----------------
--------------------------------------------------------------------------------------------B-----------------------------------------------------------------------------------------------o------------
------------------------------------------------------------BB?B--------------------------------------------------------------------------------o----------------B-------------------B-----------------v-
---------B-----------------------------------oB----------------------------------------------------------------B---B-------------------?B-------------------?--------o---------------------------------f-
--------------------------------B?B----B------------------------B-------------------------------B---------------------------------------------------------------------B----------------B---------------f-
--------------B--------o-------------------------------------------------------o--------------------B----------------------------------------------------------B---------------------------------------f-
----------------------------------------------------------------------------------------------------------------------o---------------------------------o------------------------------o-----------o---f-
-----------------o-------------------T-------------T------T-------o--------------------------------------------------------------------------o-------------------------T------T------------------------f-
------T-----T-----T-----------T------|-------------|------|------------------------------------T------------------------------o----------T-T-----------T--------T------|---T--|---------------T-----T--f-
m-----|-E---|-----|-----------|------|-------------|E-----|------------------------------------|--------------------------------E--E-----|-|-----------|--------|------|---|--|------------E-E|---E-|----
X--XXXXXXXX--XXXXXXXXXXXXXXXXXXXXXXXXXXXXXXXXXXXXXXXXXXXXXXXX--XXXXXXXXXXXXXXXXXXXXXXXXXXXX--XXXXXXXX--XXXXXXXXXXXXXXXXXX--XXXXXXXXXXXXXXXXXXXXXXXXXXXXXXXXXXXXXXXXXXXXXXXXXXXXXXXXXXXXXXXXXXXXXXXXXXXXX-
