---------------------------------------------------------------------------------------------------------------------------------------------------------------------------------------------------------
---------------------------------------------------------------------------------------------------------------------------------------------------------------------------------------------------------
---------------------------------------------------------------------------------------------------------------------------------------------------------------------------------------------------------
---------------------------------------------------------------------------------------------------------------------------------------------------------------------------------------------------------
---------------------------------------------------------------------------------------------------------------------------------------------------------------------------------------------------------
----------------------------------------B----------------------------B----?-------------------B--------B?B---------------------B-----B?B-----------B--------------------------------------B--------------
--------------------B?B----------B------------------------------B?B----------B------------------------------------------------B-------------------------------B-----B------------------------------------
--------------------------------------B?B----------------BB-------------B----------------------------------------------B?B------B-------------------------------------------B--------------------B-----v-
------?-B----------------------------------B------------B--B---------------B------------B--------------------------------B-----------------------------------------o-----------------------------------f-
-----------B?B-o-------------------------------------B-------------?----------------------------------------------------------------o--------------------------------------------B---------------------f-
-------------?------------------------------------B---------------B---B----------B------------------------------------------------------?---B?B--------------------------------------------------------f-
-------------------------------------------------------------------------------------------------------------------------------------------------------------------------------------------------------f-
----------------------------------T-------------------------------------------------------------T--------------------------------------T---------------T--------------T--------------T---------T--T----f-
--------------------T-----------T-|----------------T-----------TT---------------------T---------|-----------------T---T----------------|---------------|--------------|------T-T-----|---------|T-|----f-
m-------------------|-----------|-|----------------|-----------||--------E--------E--E|---------|-----------------|---|----------------|---E----E------|----E---------|--E---|-|-----|---------||-|------
X--XXXXXXXXXXXXXXXXXX--XXXXXXXX--XXXXXXXXXXXXXXXXXX--XXXXXXXXXXXXXXXXXXXXXXXXXXXXXXXXXXXXXXXXXXXXXXXXXXXXXXXXXXXXXXXXXXXX--XXXXXXXXXXXXXXXXXXXXXXXXXXXX--XXXXXXXXXXXXXXXXXXXXXXXXXXXXXXXXXXXXXX--XXXXXXX-
