---------------------------------------------------------------------------------------------------------------------------------------------------------------------------------------------------------
---------------------------------------------------------------------------------------------------------------------------------------------------------------------------------------------------------
---------------------------------------------------------------------------------------------------------------------------------------------------------------------------------------------------------
---------------------------------------------------------------------------------------------------------------------------------------------------------------------------------------------------------
---------------------------------------------------------------------------------------------------------------------------------------------------------------------------------------------------------
-------------------------------------------------B?B---------------o------------------------------B------o----------------------------B---B---------------------------B-B-?-------------B----------------
--------------------------------------------------------------------------------------------B-----------------------------------------------------------------------------------------------o------------
------------------------------------------------------------B??B--------------------------------------------------------------------------------o----------------B-------------------B-----------------v-
---------B-----------------------------------oB----------------------------------------------------------------B---B-------------------?B----------------------------o---------------------------------f-
--------------------------------B?B----?------------------------B-------------------------------B---------------------------------------------------------------------------B----------B---------------f-
--------------B--------o-------------------------------------------------------o--------------------B----o-------------------o----------------------------o--------------------------------------------f-
------------------------------------------------------------------------------------o---------------------------------o----------------------------------------------------------------------------o---f-
------------------------o------------T-------------T------T-------o--------------------------------------------------------------------------o-------------------------T------T---o--------------------f-
------T-----T-----T-----------T------|-------------|------|---------------o--------------------T-----------o------------------o----------T-T-----------T--------T------|--oT--|---------------T-----T--f-
m-----|-E---|-----|-----------|------|-------------|E-----|------------------------------------|--------------------------------E--E-----|-|-----------|--------|------|---|--|--------------E|----E|----
X--XXXXXXXX--XXXXXXXXXXXXXXXXXXXXXXXXXXXXXXXXXXXXXXXXXXXXXXXX--XXXXXXXXXXXXXXXXXXXXXXXXXXXX--XXXXXXXX--XXXXXXXXXXXXXXXXXX--XXXXXXXXXXXXXXXXXXXXXXXXXXXXXXXXXXXXXXXXXXXXXXXXXXXXXXXXXXXXXXXXXXXXXXXXXXXXX-
