---------------------------------------------------------------------------------------------------------------------------------------------------------------------------------------------------------
---------------------------------------------------------------------------------------------------------------------------------------------------------------------------------------------------------
---------------------------------------------------------------------------------------------------------------------------------------------------------------------------------------------------------
---------------------------------------------------------------------------------------------------------------------------------------------------------------------------------------------------------
---------------------------------------------------------------------------------------------------------------------------------------------------------------------------------------------------------
-------------------------------------------------B?B---------------o------------------------------B------o----------------------------B---B---------------------------B-?-?-------------?----------------
--------------------------------------------------------------------------------------------B-----------------------------------------------------------------------------------------------o------------
------------------------------------------------------------BB??--------------------------------------------------------------------------------o----------------?-------------------B-----------------v-
---------B-----------------------------------oB----------------------------------------------------------------B---B------------------B??-------------------?--------o----------------------------o----f-
--------------------------------B?B----?------------------------B-------------------------------B--------------------------------------------------------------------B-----------------B---------------f-
--------------B--------o-------------------o-----------------------------------o--------------------B-------------------------------------------o---------o--------------------------------------------f-
--------------------------------------------------------------------------------------------------------o-------------o----------------------------------------------------------------o-----------o---f-
-------------------------------------T-------------T------T-------o--------------------------o-----------------------------------------------o-------------------------T------T------------------------f-
------T-----T-----T-----------T------|-------------|------|------------------------------------T------------------------------o----------T-T-----------T--------T------|---T--|---------------T-----T--f-
m-----|-E---|-----|----------E|------|-------------|E-----|------------------------------------|--------------------------------E--E-----|-|-----------|------E-|------|---|--|--------------E|-----|----
X--XXXXXXXX--XXXXXXXXXXXXXXXXXXXXXXXXXXXXXXXXXXXXXXXXXXXXXXXX--XXXXXXXXXXXXXXXXXXXXXXXXXXXX--XXXXXXXX--XXXXXXXXXXXXXXXXXX--XXXXXXXXXXXXXXXXXXXXXXXXXXXXXXXXXXXXXXXXXXXXXXXXXXXXXXXXXXXXXXXXXXXXXXXXXXXXX-
