---------------------------------------------------------------------------------------------------------------------------------------------------------------------------------------------------------
---------------------------------------------------------------------------------------------------------------------------------------------------------------------------------------------------------
---------------------------------------------------------------------------------------------------------------------------------------------------------------------------------------------------------
---------------------------------------------------------------------------------------------------------------------------------------------------------------------------------------------------------
---------------------------------------------------------------------------------------------------------------------------------------------------------------------------------------------------------
----?B------B---------------------------B------------------------?-------------------------------------B--------------------B?B--------------------o-B------------------B--------------------------------
-------------------B---------------------------------------------B-------?BB---------------B-------------------------o---B----------------------------------------B----?---------------------------------
---------------------------------------------------------------B-BB?-----------o-----------------------?----------B-B----------------------------------------------------------------------------------v-
-----------------------------------------------------------------------------?---------------------------------?-------B----------------------------------------B----o---------------------B-----------f-
----------??B---------------------------------------------?B-------?-------B?B--------Bo---------------------------------------------------------------------B-------------o----------------B----------f-
--------------------------------------------------------o---o----------------------------B------------------------B-----------?------------B------B----------------------------------------------------f-
--------------------------------------------------------------o----------------o-----------------------------------------------------------------------o-----------------------------------------------f-
-T--------------T-----T---T---------------o-------o------T-------------------------o--------------------------------------------T---------T-----T----------------------------------T---------------T---f-
-|---------o----|-----|---|--T---T--T--------------------|-----------------------------------T------------------------o--------T|---T-----|-o---|--------------T------------o------|---------------|--Tf-
m|--------------|-----|---|--|---|E-|-----------E--------|----EE-----------------------------|-E----------E--------------------||-E-|-----|-----|--------E-----|------------------E|-----E---------|--|--
XXXXXXXXXXXXXXXXXXXXXXXXXXXXXXXXXXXXXXXXX--XXXXXXXXXXXXXXXXXXXXXXXXXXXXXXXXXXXXXXXXXXXXXXXXXXXXXXXXXX--XXXXXXXXXXXXXXXXXXXXXXXXXXXXXXXXXXXXXXXXXXXXXXXXXXXXXXXXXXXXXXXXXXXX--XXXXXXXXXXXXXXXXXX--XXXXXXX-
