---------------------------------------------------------------------------------------------------------------------------------------------------------------------------------------------------------
---------------------------------------------------------------------------------------------------------------------------------------------------------------------------------------------------------
---------------------------------------------------------------------------------------------------------------------------------------------------------------------------------------------------------
---------------------------------------------------------------------------------------------------------------------------------------------------------------------------------------------------------
---------------------------------------------------------------------------------------------------------------------------------------------------------------------------------------------------------
-----------B---------------------------------------------B--------B------------B---------?------B--B--------B--------------------------------------------------------------------------------------------
---------------------B-------------------B-----------------------------------B------------------------------------?---------------------------B------------------------B---------------B-----------------
------------------------------------------------------------------------------B---------------------------------?-----B?B-----------------------------B---------------B--------------------------------v-
-----------------------------------------------------------------B---B------------------------------------------------------o-------------B-------------------------------------------B----------------f-
-o---B-?----------------------------------------B-------------------B-------------------------B?B--------------------------------------------------------------o-------------------B-------------B-----f-
----?--------------------------------------------------------------------?----------------------------------------------B--?-------------------------------------B--------------B---B------------------f-
-------------------------------------------------------------------------------------------------------------------------------------------------------------------------------------------------------f-
-------------------------TT------------T---------------------TT---------T------------T--------------T----------T--------------T------------T---T------------T---------------------------T--T-----------f-
-------------------------||------------|----------TT---------||---------|------------|-------T------|T---------|---T----------|----T-------|---|---T--------|---T-----------------------|--|-----------f-
m------------------------||-------E----|----------||E--------||---------|------------|E------|------||---------|---|----------|----|-----E-|---|---|--------|---|---------E-------------|--|-------------
XXXXXXXXXXX--XXXXXXXX--XXXXXXXX--XXXXXXXXXXXXXXXXXX--XXXXXXXXXXXXXXXXXXXXXXXXXXXX--XXXXXXXXXXXXXXXXXX--XXXXXXXXXXXXXXXXXXXXXXXXXXXXXXXXXXXXXX--XXXXXXXXXXXXXXXXXXXXXXXXXXXX--XXXXXXXXXXXXXXXXXX--XXXXXXX-
