---------------------------------------------------------------------------------------------------------------------------------------------------------------------------------------------------------
---------------------------------------------------------------------------------------------------------------------------------------------------------------------------------------------------------
---------------------------------------------------------------------------------------------------------------------------------------------------------------------------------------------------------
---------------------------------------------------------------------------------------------------------------------------------------------------------------------------------------------------------
---------------------------------------------------------------------------------------------------------------------------------------------------------------------------------------------------------
-------------------------B------------------------------B----?---o-B-B---------------------------------------------------------------B--------------B----------------------------------------------------
-----------------------------------------------------------------------?---------B?B------B--B--B-----------------o-------------B?B----------------------------B-----------------------------------------
----------------------------------------------B?B-----------------B---o-?----------B?B---------?---------B------------------------------------------------------o-----------B--------B-----------------v-
-------------------------------o------------B?B-o---B?B------------------------------------------------------B?B---------------B?B---------B?B?-------------------B-------o----------------------------f-
--------------------------B------------o---------?----------------------------B?B--------?-------------------B--------------------------------------------------------?------------------B---------B---f-
-------------------------------B?B-B--------------------------o--------------------------------------B-----B------------------------------------------------B-------------------B?B---B----------B?B---f-
-------------------------------------------------------------------------------------------------------------------------------------------------------------------------------------------------------f-
-T----------T---T---------------------T---------------T-------------------------------T-------------------------------------T------------------------------------------T-----T--------------T----T--T--f-
-|-----T--T-|---|---------------------|----TT---------|--------T-------------T--------|------------------------T-----T------|---------------------------------------T--|-----|--------------|---T|--|--f-
m|-----|--|-|-E-|---------------------|----||---------|E-------|-------------|--------|------------------------|-----|------|--E--------------------------E---------|--|-----|--------------|---||--|----
X--XXXXXXXXXXXXXXXXXXXXXXXXXXXX--XXXXXXXX--XXXXXXXX--XXXXXXXXXXXXXXXXXX--XXXXXXXXXXXXXXXXXX--XXXXXXXX--XXXXXXXXXXXXXXXXXX--XXXXXXXXXXXXXXXXXXXXXXXXXXXXXXXXXXXXXXXXXXXXXXXX--XXXXXXXXXXXXXXXXXX--XXXXXXX-
