---------------------------------------------------------------------------------------------------------------------------------------------------------------------------------------------------------
---------------------------------------------------------------------------------------------------------------------------------------------------------------------------------------------------------
---------------------------------------------------------------------------------------------------------------------------------------------------------------------------------------------------------
---------------------------------------------------------------------------------------------------------------------------------------------------------------------------------------------------------
---------------------------------------------------------------------------------------------------------------------------------------------------------------------------------------------------------
----B?------B---------------------------B------------------------?-------------------------------------B--------------------B?B--------------------o-B------------------B--------------------------------
-------------------B---------------------------------------------B-------?BB---------------B-------------------------o---BB-----------------------------?---------?----?---------------------------------
---------------------------------------------------------------B-B?B-----------o-----------------------?----------B-?----------------------------------------------------------------------------------v-
-----------------------------------------------------------------------------B-----------------------------------------?----------------------------------------B----o---------------------B-----------f-
----------?BB------B----------------------?---------------BB-------?-------B?B--------?o--------?------------------------------------------------------------B-------------o----------------B----------f-
---------------------------------------------------B--------o----------------------------B------------------------B------------------------B------B----------------------------------------------------f-
--------------o--o-------------------------------------------------o-----------o-----------------------------------------------------------o---------------------------------o-------------------------f-
-T--------------T-----T---T-----------------------o------T-------------------------o--------------------------------------------T---------T-----T-----o----------------------------T---------------T---f-
-|--------------|-----|---|--T---T--T--------------------|-----------------------------------T------------------------o--------T|---T-----|-----|--------------T-------------------|---------------|--Tf-
m|--------------|-----|---|--|---|--|--------------------|----EE-----------------------------|-E----------E--------------------||-E-|-----|-----|---E----E-----|------------------E|-----E---------|--|--
XXXXXXXXXXXXXXXXXXXXXXXXXXXXXXXXXXXXXXXXX--XXXXXXXXXXXXXXXXXXXXXXXXXXXXXXXXXXXXXXXXXXXXXXXXXXXXXXXXXX--XXXXXXXXXXXXXXXXXXXXXXXXXXXXXXXXXXXXXXXXXXXXXXXXXXXXXXXXXXXXXXXXXXXX--XXXXXXXXXXXXXXXXXX--XXXXXXX-
