---------------------------------------------------------------------------------------------------------------------------------------------------------------------------------------------------------
---------------------------------------------------------------------------------------------------------------------------------------------------------------------------------------------------------
---------------------------------------------------------------------------------------------------------------------------------------------------------------------------------------------------------
---------------------------------------------------------------------------------------------------------------------------------------------------------------------------------------------------------
---------------------------------------------------------------------------------------------------------------------------------------------------------------------------------------------------------
----BB------B---------------------------?------------------------B-------------------------------------B--------------------??B--------------------o-B------------------B--------------------------------
-------------------B---------------------------------------------B-------?BB---------------B-------------------------o---BB---------------------------------------?----B---------------------------------
---------------------------------------------------------------B-??B-----------o---------------B------------------B-B----------------------------------------------------------------------------------v-
-----------------------------------------------------------------------------B--------B--------------------------------?----------------------------------------B----o---------------------B-----------f-
----------?BB-----------------------------?---------------BB-------?-------BBB--------Bo---------------------------------------------------------------------B-------------o----------------B----------f-
---------------------------------------------------o--------o----------------------------B------------------------B------------------------B------B------o---------------------------------------------f-
-------------------------------------------------------------------------------o---------------o----------------------o--------------------------------------------------------------------------------f-
-T--------------T-----T---T-----------------------o------T-------------------------o--------------------------------------------T---------T-----T----------------------------------T---------------T---f-
-|--------------|-----|---|--T---T--T--------------------|--------------------------------o--T------------------------o--------T|---T-----|-----|--------------T-------------------|---------------|--Tf-
m|--------------|-----|---|--|---|--|--------------------|----EE-----------------------------|-E----------E--------------------||-EE|-----|-----|--------E-----|------------E-----E|-----E---------|--|--
XXXXXXXXXXXXXXXXXXXXXXXXXXXXXXXXXXXXXXXXX--XXXXXXXXXXXXXXXXXXXXXXXXXXXXXXXXXXXXXXXXXXXXXXXXXXXXXXXXXX--XXXXXXXXXXXXXXXXXXXXXXXXXXXXXXXXXXXXXXXXXXXXXXXXXXXXXXXXXXXXXXXXXXXX--XXXXXXXXXXXXXXXXXX--XXXXXXX-
