---------------------------------------------------------------------------------------------------------------------------------------------------------------------------------------------------------
---------------------------------------------------------------------------------------------------------------------------------------------------------------------------------------------------------
---------------------------------------------------------------------------------------------------------------------------------------------------------------------------------------------------------
---------------------------------------------------------------------------------------------------------------------------------------------------------------------------------------------------------
---------------------------------------------------------------------------------------------------------------------------------------------------------------------------------------------------------
-------------------------------------?--------------------o-------------B-----------------------B-----------o-----?-------------------B-------------------o------B---------------------------------------
-----------------o----------B-B---------------------------------------B-----------------------------------------------------------------------B?B--B-------------------?B--------------------------------
---?------------B----------------------B---?------------------?-------------------------------B?B----------------------------------------B----------------------------------------------------------B--v-
-----------------------?-----------------B?B---B------------------------------B??--------------------------------------?-----------B??----------B-----------------------------B------------B?B---------f-
-------------------?-------------o---------------------B------B----------?-------------o--------------B-----------------------------------------------------------------------o----?-------------------f-
------------------------------------------o-----------------------B---------------------------?------------o--o------B---------B??---?------B----------o-----------------------------------------------f-
-------------------------------------------------------------------------------------------------------------------------------------------------------------------------------------------------------f-
-------------T-------o----------T-----T----------T------------------T--T-----------T-----------------------T---------o---T--T-T---------------T---------------------------T-------o--------------------f-
-T-----------|------------T-----|-----|-------T--|----T-------------|--|-----------|-----------------------|-----T-T---T-|--|-|--o-----------o|------------T---o----------|----------------------------f-
m|-----------|----------E-|-----|--E--|-------|--|---E|----------E--|--|---------E-|-----------------------|-----|-|---|-|--|-|---------------|-E--E------E|E----------E--|------E---------------E-------
XXXXXXXXXXX--XXXXXXXX--XXXXXXXX--XXXXXXXXXXXXXXXXXX--XXXXXXXXXXXXXXXXXX--XXXXXXXXXXXXXXXXXXXXXXXXXXXXXXXXXXXXXXXXXXXXXXXXXXXXXXXXXX--XXXXXXXXXXXXXXXXXX-XXXXXXXXXXXXXXXXXXXXXXXXXXXXXXXXXXXXXXXX-XXXXXXX-
