---------------------------------------------------------------------------------------------------------------------------------------------------------------------------------------------------------
---------------------------------------------------------------------------------------------------------------------------------------------------------------------------------------------------------
---------------------------------------------------------------------------------------------------------------------------------------------------------------------------------------------------------
---------------------------------------------------------------------------------------------------------------------------------------------------------------------------------------------------------
---------------------------------------------------------------------------------------------------------------------------------------------------------------------------------------------------------
----BB------B---------------------------B------------------------?-------------------------------------B--------------------B?B--------------------o-B------------------B-B------------------------------
-------------------B---------------------------------B-----------B-------??B---------------B-------------------------o---BB-----------------------------B---------?----?---------------------------------
---------------------------------------------------------------B-B?B-----------o-----------------------?----------B-B----------------------------------------------------------------------------------v-
-------------------------------o---------------------------------------------?-----------------------------------------?----------------------------------------B----o---------------------B-----------f-
----------?B------------------------------?---------------BB-------B-------B?B--------?o---------------------------------------------------------------------B-------------o----------------B----------f-
------------------------------------------------------------o------o---------------------B------------------------B------------------------B------?------------------------------------------------o---f-
----------------------------------------------o--------------------------------o--------------------------------------------------------------------------o--------------------------------------------f-
-T--------------T-----T---T-----------------------o------T-------------------------o--------------------------------------------T---------T-----T--------------------------------o-T---------------T---f-
-|---------o----|-----|---|--T---T--T--------------------|--------------o-------------------oT------------------------o--------T|---T-----|-----|--------------T-------------------|------o--------|--Tf-
m|--------------|-----|E--|--|E--|--|--------------------|----E--------------E---------------|-E----------E--------------------||-E-|-----|-----|--------E-----|------------------E|-----E---------|--|--
XXXXXXXXXXXXXXXXXXXXXXXXXXXXXXXXXXXXXXXXXX-XXXXXXXXXXXXXXXXXXXXXXXXXXXXXXXXXXXXXXXXXXXXXXXXXXXXXXXXXX--XXXXXXXXXXXXXXXXXXXXXXXXXXXXXXXXXXXXXXXXXXXXXXXXXXXXXXXXXXXXXXXXXXXX--XXXXXXXXXXXXXXXXXX--XXXXXXX-
