---------------------------------------------------------------------------------------------------------------------------------------------------------------------------------------------------------
---------------------------------------------------------------------------------------------------------------------------------------------------------------------------------------------------------
---------------------------------------------------------------------------------------------------------------------------------------------------------------------------------------------------------
---------------------------------------------------------------------------------------------------------------------------------------------------------------------------------------------------------
---------------------------------------------------------------------------------------------------------------------------------------------------------------------------------------------------------
--------------------------------------------------------------------------------------------------------------------B------------------------------------------------------------------------------------
-------------B-----------------------------------------------------------------------------o--------------------------------------------------------------------------------------------------------?----
-------------------------------------------------------------------------------------------------------------------------------------------------------------------------------------------------------v-
-?-----B---------------?--------M-----------?------?-----------------------o--------------------------------------------B-------------------------------------------------------o----------------------f-
---------------------------B-----------------------------------?----------------------------------------------------------------o----------------------------------------------------------------------f-
-------------------o-----------------------B-----------B-------o----------o-------------------------------------------------------------------------B--------------------B---------o-------------------f-
------TT------------------------------------------------o-------------------T------T--o----------------------------------------------------------------------o-----------------------------------------f-
------||----------------o---------------------------------------------------|------|-T----------------------------------------------------T-----T--T----------------T-T----------------------------T---f-
-----o||-o--------------------T---T------------------T-----T---o------------|------|-|-----------------------------------T----------T-----|-----|--|-------------o--|-|------T---------------------|---f-
m-----||----------------E-----|---|-------E----------|-----|-------------E--|------|E|-E------------E--------------------|----------|-E--E|-----|--|----------------|-|------|-------E-----E-------|-----
XXXXXXXXXXXXXXXXXXXXXXXXXXXXXXXXXXXXXXXXXXXXXXXXXXXXXXXXXXXXXXXXXXXXXXXXXXXXXXXXXXXXXXXXXXXXXXXXXXXXXXXXXXXXXXXXXXXXXXXXXXXXXXXXXXXXXXXXXXXXXXXXXXXXXXXXXXXXXXXXXXXXXXXXXXXXXXXXXXXXXXXXXXXXXXXXXXXXXXXX-
