---------------------------------------------------------------------------------------------------------------------------------------------------------------------------------------------------------
---------------------------------------------------------------------------------------------------------------------------------------------------------------------------------------------------------
---------------------------------------------------------------------------------------------------------------------------------------------------------------------------------------------------------
---------------------------------------------------------------------------------------------------------------------------------------------------------------------------------------------------------
---------------------------------------------------------------------------------------------------------------------------------------------------------------------------------------------------------
--------------------B-----------------------------B?B---------------B---B-------oB-----------BB------------------------------------------------------------B------------B?B-----------B------------------
-----------------------------------------------------------------B--------------------------------------------B----?----------------------------------------------B------------------------B-------------
-----B-----------------B-----------B----?---B--------------------------?----------BB------------B--------------------------B---------------------------------------------------------------------------v-
---------------------------B------------------------B---------------------------------B---------------------------------------------------------------------------------------B------------------------f-
------B-B----------------------------------------------------------------B-------------------------B-----------------B?B----------------------B------------------------------------------------o-------f-
----------------------------------B-----------------------------------------------------B?B--------------------------------------------B----B------------------------B?B---B-----------------B---------f-
-------------------------------------------------------------------------------------------------------------------------------------------------------------------------------------------------------f-
-T-----T---------T-------------TT---------------T------T----------------------------------------------T----------------------------------------T-------------------------------------------------T-----f-
-|--T--|---------|-------------||------T---T----|------|---------------------------------------------T|-----------------T----T-----------------|--------------T----T----------------------T---T--|----Tf-
m|--|--|---------|-------------||------|---|----|E-----|----------------------EE---------------------||-----------------|----|-----------------|--------------|----|E-------E------------E|---|--|----|--
XXXXXXXXXXXXXXXXXXXXXXXXXXXXXXX--XXXXXXXXXXXXXXXXXXXXXXXXXXXXXXXXXXXXXXXXXXXXXXXX--XXXXXXXX--XXXXXXXXXXXXXXXXXXXXXXXXXXXXXXXXXXXXXX--XXXXXXXXXXXXXXXXXXXXXXXXXXXXXXXXXXXXXXXXXXXXXXXXXXXXXXXXXX--XXXXXXX-
