---------------------------------------------------------------------------------------------------------------------------------------------------------------------------------------------------------
---------------------------------------------------------------------------------------------------------------------------------------------------------------------------------------------------------
---------------------------------------------------------------------------------------------------------------------------------------------------------------------------------------------------------
---------------------------------------------------------------------------------------------------------------------------------------------------------------------------------------------------------
---------------------------------------------------------------------------------------------------------------------------------------------------------------------------------------------------------
-------------------------------------?--------------------o-------------B-?---------------------B-----------o-----?-------------------B-------------------o------B---------------------------------------
-----------------o----------B-----------------------------------------?-----------------------------------------------------------------------B?B--B-------------------?---------------------------------
---B------------B----------------------B---B------------------?-------------------------------BB-----------------------------------------B----------------------------------------------------------B--v-
------?----------------------------------B?B---B------------------------------B?B--------------------------------------?-----------B?B----------B-----------------------------?------------B?B---------f-
-------------------?-------------o---------------------B------B----------B-------------o--------------B-----------------------------------------------------------------------o----?-------------------f-
---------o--------------------------------------------------------?---------------------------?----------------------?---------B??---B------?----------------------------------------------------------f-
-------------------------------------------------------------------------------------------------------------------------------------------------------------------------------------------------------f-
-------------T-------o----------T-----T----------T------------------T--T-----o-----T--------------o--------T---------o---T--T-T---------------T---------------------------T-o--------------------------f-
-T-----------|-o----------T-----|-----|-------T--|----T-------------|--|--o--------|-----------------------|-----T-T---T-|--|-|--o-----------o|------------T--------------|----------------------------f-
m|-----------|------------|-----|--E--|-------|--|---E|-------------|--|---------E-|-----------------------|-----|-|---|-|--|-|---E--------E--|----E------E|E-------------|------E---------------E-------
XXXXXXXXXXX--XXXXXXXX--XXXXXXXX--XXXXXXXXXXXXXXXXXX--XXXXXXXXXXXXXXXXXX--XXXXXXXXXXXXXXXXXXXXXXXXXXXXXXXXXXXXXXXXXXXXXXXXXXXXXXXXXX--XXXXXXXXXXXXXXXXXX-XXXXXXXXXXXXXXXXXXXXXXXXXXXXXXXXXXXXXXXX-XXXXXXX-
