---------------------------------------------------------------------------------------------------------------------------------------------------------------------------------------------------------
---------------------------------------------------------------------------------------------------------------------------------------------------------------------------------------------------------
---------------------------------------------------------------------------------------------------------------------------------------------------------------------------------------------------------
---------------------------------------------------------------------------------------------------------------------------------------------------------------------------------------------------------
---------------------------------------------------------------------------------------------------------------------------------------------------------------------------------------------------------
-----B?B-------------------------------------------o-----o-----------------------------------------------------------------------------------------------------------------------------------------------
-------B-o----------------------------------B-----------------B?B--o--------?-----o----------------------------------------------o----------------------o------------------------------------------------
--------------B--B?B------o------------------B?B----------------------------------------------?--?-------------o---B--------------B--------------?--------------------B----------B-------------BB------v-
-----------------------------------------------------------------------B------------------------------------------?---o-------------?------------------------------------------------------------------f-
-----------------------------------------------------------------------------------------o----------B--o-------------------------------------B--------------------------------------------------------Bf-
------------------------------------------B---------------------B?B------------------B------------?-----------------------------------B----o-----------B--B-------------------B?B----------------------f-
-------------------------------------------------------------------------------------------------------------------------------------------------------------------------------------------------------f-
-T-----------------------T---T-------------------T--T-T------------------------T---------------------------T-----------------------------------------------------------------------------T---------T---f-
-|-T--------------------T|---|-T-----------------|--|-|------------------------|-------------------T-------|----T--------------------T-------------------T--T----------------------------|----T----|---f-
m|-|--------------------||---|-|-----------------|--|E|E----------------E------|-------------------|-------|----|E-------------------|---E---------------|--|-E------------E-------E-----|----|----|-----
X--XXXXXXXXXXXXXXXXXX--XXXXXXXXXXXXXXXXXXXXXXXXXXXXXXXXXXXXXXXXXXXXXXXXXXXXXXXXXXXXXXXXXXXXXXXXXXXXXXXXXXXXXXXXXXXXXXXXXXXXXXXXXXXXXXXXXXXXXX--XXXXXXXXXXXXXXXXXX--XXXXXXXX--XXXXXXXX--XXXXXXXX--XXXXXXX-
