---------------------------------------------------------------------------------------------------------------------------------------------------------------------------------------------------------
---------------------------------------------------------------------------------------------------------------------------------------------------------------------------------------------------------
---------------------------------------------------------------------------------------------------------------------------------------------------------------------------------------------------------
---------------------------------------------------------------------------------------------------------------------------------------------------------------------------------------------------------
---------------------------------------------------------------------------------------------------------------------------------------------------------------------------------------------------------
----BB------B---------------------------B------------------------B-------------------------------------B--------------------B??--------------------o-B------------------B--------------------------------
---------------------?-------------------------------------------B-------???---------------B-------------------------o---BB---------------------------------------?----?---------------------------------
---------------------------------------------------------B-----?--?B-----------------------------------?----------?-B----------------------B-----------------------------------------------------------v-
-----------------------------------------------------------------------------?-----------------------------------------?----------------------------------------B----o---------------------B-----------f-
----------?BB-----------------------------?---------------?B-------?-------B?B--------?o---------------------------------------------------------------------B-------------o----------------B----------f-
-------o----------------------------------------------------o----------------------------B------o------B----------B------------------------B------B--------------------------------------------------o-f-
-------------------------------------------------------------------------------o-------------------------------------------------------o---------------------------------------------------------------f-
-T--------------T-----T---T-----------------------o------T-------------------------o--------------------------------------------T---------T-----T----------------------------------T---------------T---f-
-|--------------|-----|---|--T---T--T--------------------|-----------------------------------T------------------------o--------T|---T-----|-----|--------------T-------------------|---------------|--Tf-
m|--------------|-----|E--|--|---|--|--------------------|----EE-----------------------------|-E----------E-------------E------||-E-|-----|-----|--------E-----|------------------E|-----E---------|--|--
XXXXXXXXXXXXXXXXXXXXXXXXXXXXXXXXXXXXXXXXX--XXXXXXXXXXXXXXXXXXXXXXXXXXXXXXXXXXXXXXXXXXXXXXXXXXXXXXXXXX--XXXXXXXXXXXXXXXXXXXXXXXXXXXXXXXXXXXXXXXXXXXXXXXXXXXXXXXXXXXXXXXXXXXX--XXXXXXXXXXXXXXXXXX--XXXXXXX-
