---------------------------------------------------------------------------------------------------------------------------------------------------------------------------------------------------------
---------------------------------------------------------------------------------------------------------------------------------------------------------------------------------------------------------
---------------------------------------------------------------------------------------------------------------------------------------------------------------------------------------------------------
---------------------------------------------------------------------------------------------------------------------------------------------------------------------------------------------------------
---------------------------------------------------------------------------------------------------------------------------------------------------------------------------------------------------------
----BB------B---------------------------B------------------------?-------------------------------------B--------------------B?B--------------------o-B------------------B--------------------------------
-------------------B---------------------------------------------B-------?BB---------------B-------------------------o---BB-----------------------------?---------B----B---------------------------------
---------------------------------------------------------------B-?BB-----------o-----------------------?----------B-B----------------------------------------------------------------------------------v-
-----------------------------------------------------------------------------B-----------------------------------------?----------B-----------------------------B----o---------------------B-----------f-
----------??B-----------------------------?---------------BB-------?-------B??--------?o---------------------------------------------------------------------B-------------o----------------B----------f-
--------o---------------------------------------------------o----------------------------?------------------------?----------------------o-B------B----------------------------------------------------f-
-------------------------------------------------------------------------------o----------------------------------------------------------------o------o--------o--------------------o-----------------f-
-T--------------T-----T---T-----------------------o------T-------------------------o-----------------------o--------------------T---------T-----T----------------------------------T---------------T---f-
-|--------------|-----|---|--T---T--T--------------------|-----------------------------------T------------------------o--------T|---T-----|-----|--------------T-------------------|---------------|--Tf-
m|--------------|-----|---|--|---|--|--------------------|----EE-----------------------------|-E--E-------E--------------------||-E-|-----|-----|--------E-----|------------------E|-----E---------|--|--
XXXXXXXXXXXXXXXXXXXXXXXXXXXXXXXXXXXXXXXXX--XXXXXXXXXXXXXXXXXXXXXXXXXXXXXXXXXXXXXXXXXXXXXXXXXXXXXXXXXX--XXXXXXXXXXXXXXXXXXXXXXXXXXXXXXXXXXXXXXXXXXXXXXXXXXXXXXXXXXXXXXXXXXXX--XXXXXXXXXXXXXXXXXX--XXXXXXX-
