---------------------------------------------------------------------------------------------------------------------------------------------------------------------------------------------------------
---------------------------------------------------------------------------------------------------------------------------------------------------------------------------------------------------------
---------------------------------------------------------------------------------------------------------------------------------------------------------------------------------------------------------
---------------------------------------------------------------------------------------------------------------------------------------------------------------------------------------------------------
---------------------------------------------------------------------------------------------------------------------------------------------------------------------------------------------------------
--------------------------------------------------B--B-------B-------------?------------------?----------B-----------------------------------------------------------------------------------B-----------
----------o---------?---------------------------------------------------------o-------B-------------------------------------------------------------B---------o--B---------B----------?------------------
-----------------------?-------B-B?B---------------B------------?BB------------------------------------------B---------B------------------------B?--------------------B---------------------B----------v-
-----------------------------------------------------------------------------------B----------------------------------------------------------------------------------------------------B--------------f-
------------?--------------------------------------??----B----------B----------------------B--------------------------------------------------------------------------------------B------------------B-f-
---o--------B------o--------B---?--?-------?------------------------------------------------o--B--------------------B--------------------------------B---------B------B??------------------------------f-
-------------------------------o---------o-------o--------------------------------------------------o----------------o-------------------------------------------o------------o------------------------f-
-------TTT---T------o--------T------------T-T--o------T-------TT----------------T----T--o-----------------T-------------T----o-T-T---------T-T-T-----------------------------------o--o-------T--------f-
-----T-|||---|-----T------o--|T------o----|-|---T-----|---TT--||----------------|---T|---------------T----|---------o---|------|-|--T--T---|-|-|------------o-----------------T---------------|--------f-
m----|-|||---|-----|---------||-----------|-|---|-----|-E-||--||----------------|E--||-------E-------|----|-------------|------|-|--|-E|---|-|-|--------E-E-------------------|---------------|----------
XXXXXXXXXXXXXXXXXXXXXXXXXXXXXXXXXXXXXXXXXXXXXXXXXXX--XXXXXXXX--XXXXXXXXXXXXXXXXXX--XXXXXXXXXXXXXXXXXXXXXXXXXXXXXXXXXXXXXXXXXXXXXXXX--XXXXXXXXXXXXXXXXXX--XXXXXXXXXXXXXXXXXXXXXXXXXXXXXXXXXXXXXX--XXXXXXX-
