---------------------------------------------------------------------------------------------------------------------------------------------------------------------------------------------------------
---------------------------------------------------------------------------------------------------------------------------------------------------------------------------------------------------------
---------------------------------------------------------------------------------------------------------------------------------------------------------------------------------------------------------
---------------------------------------------------------------------------------------------------------------------------------------------------------------------------------------------------------
---------------------------------------------------------------------------------------------------------------------------------------------------------------------------------------------------------
----BB------?---------------------------?------------------------?-------------------------------------B--------------------B?B--------------------o-B------------------B--------------------------------
-------------------B---------------------------------------------B-------B??---------------?-------------------------o---BB---------------------------------------B----?---------------------------------
---------------------------------------------------------------B-??B-----------o-----------------------?----------?-B----------------------------------------------------------------------------------v-
-----------------------------------------------------------------------------B-----------------------B-----------------?----------------------------------------B----o---------------------B-----------f-
-----------BB-----------------------------?---------------BB-------?-------B?B--------Bo---------------------------------------------------------------------B-------------o----------------B----------f-
---------------------------------------o--------------------o----------------------------B------------------------?------------------------B------B----------------------------------------------------f-
----------------------------------------------o-----------o--------------------o-----------------------------------------------------------------------------------------------------------------------f-
-T--------------T-----T---T-----------o-----------o------T-------------------------o--------------------------------------------T---------T-----T----------------------------------T---------------T---f-
-|--------------|-----|---|--T---T--T--------------------|---------------o-------------------T------------------------o--------T|---T-----|-----|--------------T---o---------------|---------------|--Tf-
m|--------------|-----|---|--|---|--|------E-------------|----EE-----------------------------|-E-E--------E--------------------||-E-|-----|-----|--------E-----|------------------E|-----E---------|--|--
XXXXXXXXXXXXXXXXXXXXXXXXXXXXXXXXXXXXXXXXX--XXXXXXXXXXXXXXXXXXXXXXXXXXXXXXXXXXXXXXXXXXXXXXXXXXXXXXXXXX--XXXXXXXXXXXXXXXXXXXXXXXXXXXXXXXXXXXXXXXXXXXXXXXXXXXXXXXXXXXXXXXXXXXX--XXXXXXXXXXXXXXXXXX--XXXXXXX-
