---------------------------------------------------------------------------------------------------------------------------------------------------------------------------------------------------------
---------------------------------------------------------------------------------------------------------------------------------------------------------------------------------------------------------
---------------------------------------------------------------------------------------------------------------------------------------------------------------------------------------------------------
---------------------------------------------------------------------------------------------------------------------------------------------------------------------------------------------------------
---------------------------------------------------------------------------------------------------------------------------------------------------------------------------------------------------------
----B----------------------------------------B?B---------------??-o-------B--------------------B-----------------------------------------------------B---------------------------B----B-o----------------
--------------------------B----------------------------------------?-------------B?B-----------------o------------------------------------B-------------------------------B--------------------B---------
------------------B-----------------B?B------B---------------B-------------B-------------B-------------------------------------------------------------B?B--------------------------B------------------v-
-------------------------------------------------------------------------------------------------------B----------------B---------------------B----------------?B-----B--------------------------------f-
---------------------------------B--------------------------------------------------B------B----B-----------------------------B--------?-----B---------------------------------------------------------f-
--------B---------------------------------------------?-----------------B-------?------------B-------------B?B-----------B?B---------------------------------------------------------------------------f-
-------------------------------------------------------------------------------------------------------------------------------------------------------------------------------------------------------f-
--------------------------------------T---------------------T---------------------------------------------T----------T-------------------------------------------T---------------------T----T----T-----f-
---T----------------------------------|---------------------|---------------------------------------------|----T-----|---------------------T-------T-------------|T--------------------|--TT|----|-----f-
m--|-----------------------E----------|----E----------------|---------------------------------------------|----|-----|---------------------|-------|-------------||--------------------|--|||----|-------
X--XXXXXXXXXXXXXXXXXX--XXXXXXXXXXXXXXXXXXXXXXXXXXXXXXXXXXXXXXXXXXXXXXXX--XXXXXXXX--XXXXXXXXXXXXXXXXXX--XXXXXXXXXXXXXXXXXXXXXXXXXXXX--XXXXXXXXXXXXXXXXXXXXXXXXXXXXXXXXXXXXXXXXXXXXXXXXXXXXXXXXXXXXXXXXXXX-
