---------------------------------------------------------------------------------------------------------------------------------------------------------------------------------------------------------
---------------------------------------------------------------------------------------------------------------------------------------------------------------------------------------------------------
---------------------------------------------------------------------------------------------------------------------------------------------------------------------------------------------------------
---------------------------------------------------------------------------------------------------------------------------------------------------------------------------------------------------------
---------------------------------------------------------------------------------------------------------------------------------------------------------------------------------------------------------
-----------------------------------------------------B-------?-------------?------------------B----------B-----------------------------------------------------------------------------------B-----------
----------o---------B---------------------------------------------------------o-------B-------------------------------------------------------------B---------o--B--------------------?------------------
-------------------------------B-??B---------------B------------?BB------------------------------------------?---------?----------------------------------------------B---------------------B----------v-
-----------------------------------------------------------------------------------?-------------------------------------------------------------------------------------------------------------------f-
------------B--------------------------------------B?B---?----------B----------------------B--------------------------------------------------------------------------------------?------------------B-f-
---o--o------------o--------?--------------?------------------------------------------------o--B--------------------B--------------------------------B---------B------BBBo------B-o---------o----------f-
-------------------------------o---------o-------o---------------------------------------------------------------------------------------------------------------o--o-------oo-------------------------f-
-------TTT---T------o--------T------------T-T--o------T-------TT----------------T----T--o-----------------T-------------T------T-T---------T-T-T--------------------------------------o-------T--------f-
-----T-|||---|-----T------o--|T-----------|-|---T-----|---TT--||------o---------|---T|---------------T-o--|o------------|------|-|--T--T---|-|-|-----------o------------------T---------------|--------f-
m-E--|-|||---|-----|---------||-----------|-|---|-----|-E-||--||----------------|E--||-------E-------|----|------E------|------|-|--|-E|---|-|-|--------E-E-------------------|---------------|E---------
XXXXXXXXXXXXXXXXXXXXXXXXXXXXXXXXXXXXXXXXXXXXXXXXXXX--XXXXXXXX--XXXXXXXXXXXXXXXXXX--XXXXXXXXXXXXXXXXXXXXXXXXXXXXXXXXXXXXXXXXXXXXXXXX--XXXXXXXXXXXXXXXXXX--XXXXXXXXXXXXXXXXXXXXXXXXXXXXXXXXXXXXXX--XXXXXXX-
