---------------------------------------------------------------------------------------------------------------------------------------------------------------------------------------------------------
---------------------------------------------------------------------------------------------------------------------------------------------------------------------------------------------------------
---------------------------------------------------------------------------------------------------------------------------------------------------------------------------------------------------------
---------------------------------------------------------------------------------------------------------------------------------------------------------------------------------------------------------
---------------------------------------------------------------------------------------------------------------------------------------------------------------------------------------------------------
-----------------------------------------------------B-------?-------------?------------------?----------?-----------------------------------------------------------------------------------B-----------
----------o---------B---------------------------------------------------------o-------B-------------------------------------------------------------B---------o--B--------------------?------------------
-------------------------------B-B??---------------B------------??B------------------------------------------B---------?----------------------------------------------B---------------------B----------v-
-----------------------------------------------------------------------------------B-------------------------------------------------------------------------------------------------------------------f-
------------B--------------------------------------??B---B----------B----------------------B--------------------------------------------------------------------------------------?------------------B-f-
---o---------------o--------B--------------B------------------------------------------------o--B--------------------B--------------------------------B---------B------B??-------?----------------o--o--f-
-------------------------------o---------o-------o---------------------------------------------------------------o----------------o------------------------------o-------------------------------------f-
-------TTT---T------o--------T------------T-T--o------T-------TT----------------T----T--o-----------------T-------------T------T-T--o------T-T-T----------------------------o----o----o-------T--------f-
-----T-|||---|-----T------o--|T-----------|-|---T-----|---TT--||-------o-o------|---T|---------------T----|-------------|------|-|--T--T---|-|-|-----o--------------o---------T---------------|--------f-
m-E--|-|||---|-----|---------||-----------|-|---|--E--|-E-||--||----------------|E--||-------E-------|----|---E---------|------|-|--|-E|---|-|-|--------E-E-------------------|------E--------|----------
XXXXXXXXXXXXXXXXXXXXXXXXXXXXXXXXXXXXXXXXXXXXXXXXXXX--XXXXXXXX--XXXXXXXXXXXXXXXXXX--XXXXXXXXXXXXXXXXXXXXXXXXXXXXXXXXXXXXXXXXXXXXXXXX--XXXXXXXXXXXXXXXXXX--XXXXXXXXXXXXXXXXXXXXXXXXXXXXXXXXXXXXXX--XXXXXXX-
