---------------------------------------------------------------------------------------------------------------------------------------------------------------------------------------------------------
---------------------------------------------------------------------------------------------------------------------------------------------------------------------------------------------------------
---------------------------------------------------------------------------------------------------------------------------------------------------------------------------------------------------------
---------------------------------------------------------------------------------------------------------------------------------------------------------------------------------------------------------
---------------------------------------------------------------------------------------------------------------------------------------------------------------------------------------------------------
-------------------------------------------------B?B---------------o------------------------------?------o----------------------------B---?---------------------------B-?-?-------------B----------------
--------------------------------------------------------------------------------------------B-----------------------------------------------------------------------------------------------o------------
------------------------------------------------------------BB?B--------------------------------------------------------------------------------o----------------B-------------------B-----------------v-
---------B-----------------------------------oB----------------------------------------------------------------B---B-------------------?B-------------------?--------o---------------------------------f-
--------------------------------B?B----?------------------------B-------------------------------B--------------------------------------------------------------------------------------B---------------f-
--------------B--------o-------------------------------------------------------o--------------------B-------------------------------------------B---------o--------------------------------------------f-
----------------------o-----------------------------------------------------------------------------------------------o---------------------o-------------------o----------------------o-----------o---f-
-------------------------------------T-------------T------To------o------------------------------------------o-------------------------------o-------------------------T------T--o-------------------o-f-
------T-----T-----T-----------T------|-------------|------|------------------------------------T------------------------------o----------T-T-----------T--------T------|---T--|-----------o---T-----T--f-
m-----|-E---|-----|-----------|-----E|-------------|E-----|------------------------------------|--------------------------------E--E-----|-|-----------|--------|------|---|--|--------------E|-----|----
X--XXXXXXXX--XXXXXXXXXXXXXXXXXXXXXXXXXXXXXXXXXXXXXXXXXXXXXXXX--XXXXXXXXXXXXXXXXXXXXXXXXXXXX--XXXXXXXX--XXXXXXXXXXXXXXXXXX--XXXXXXXXXXXXXXXXXXXXXXXXXXXXXXXXXXXXXXXXXXXXXXXXXXXXXXXXXXXXXXXXXXXXXXXXXXXXX-
