---------------------------------------------------------------------------------------------------------------------------------------------------------------------------------------------------------
---------------------------------------------------------------------------------------------------------------------------------------------------------------------------------------------------------
---------------------------------------------------------------------------------------------------------------------------------------------------------------------------------------------------------
---------------------------------------------------------------------------------------------------------------------------------------------------------------------------------------------------------
---------------------------------------------------------------------------------------------------------------------------------------------------------------------------------------------------------
-----------------------------------------------------B-------B-------------?------------------B----------B-----------------------------------------------------------------------------------B-----------
----------o---------?---------------------------------------------------------o-------?-------------------------------------------------------------B---------o--B--------------------?------------------
-------------------------------B-B?B---------------B------------??B------------------------------------------B---------?----------------------------------------------?---------------------B----------v-
-----------------------------------------------------------------------------------B-------------------------------------------------------------------------------------------------------------------f-
------------B--------------------------------------???---B----------B----------------------?--------------------------------------------------------------------------------------?------------------?-f-
---o---------------o--------B--------------B------------------------------------------------o--B--------------------?--------------------------------?---------B------B??-------B---------------------of-
-------------------------------o---------o-------o---------------------------------------------------------------------------------------------------------------o----------o---o----------------------f-
-------TTT---T------o--------T------------T-T--o------T-------TT----------------T----T--o-----------------T------------oT------T-T---------T-T-T----------------------------o---------o-------T--------f-
-----T-|||---|-----T------o--|T-----------|-|---T-----|---TT--||----------------|---T|------o--------T----|-------------|----o-|-|--T--T---|-|-|------------------------------T---------------|--------f-
m-E--|-|||---|-----|---------||-----------|-|---|-----|-E-||--||----E-----------|E-E||-------E-------|----|-------------|------|-|--|-E|---|-|-|--------E-E-------------------|---------------|----------
XXXXXXXXXXXXXXXXXXXXXXXXXXXXXXXXXXXXXXXXXXXXXXXXXXX--XXXXXXXX--XXXXXXXXXXXXXXXXXX--XXXXXXXXXXXXXXXXXXXXXXXXXXXXXXXXXXXXXXXXXXXXXXXX--XXXXXXXXXXXXXXXXXX--XXXXXXXXXXXXXXXXXXXXXXXXXXXXXXXXXXXXXX--XXXXXXX-
