---------------------------------------------------------------------------------------------------------------------------------------------------------------------------------------------------------
---------------------------------------------------------------------------------------------------------------------------------------------------------------------------------------------------------
---------------------------------------------------------------------------------------------------------------------------------------------------------------------------------------------------------
---------------------------------------------------------------------------------------------------------------------------------------------------------------------------------------------------------
---------------------------------------------------------------------------------------------------------------------------------------------------------------------------------------------------------
---B--B------B---------------B--------B--------B----------------?------------------B-----------------------B-------B----------------------------------B--------------?-----------------------------------
----------------?----?------------------o----------------B------------------------B-------------B-------------------------------?-------------B-------------B---------------B----------------------------
-------B-------------------------------------------------B?B----------------------------------------------------------------B--------------B-----------------------?----------B-----------------------Bv-
-----------------------B---------------------B---------------------------------------------------------------------------------------------------------------------------------------------------------f-
-------------------------------------------------B?B-----------------------------o--o---------------o------------------B?B-------B--------------------------------?-------------------B?B--------------f-
-------------------------------?-----------B---------------------------BBB-----?-----------------------B--------------------------------------B?B----------------------------------B-------------------f-
-------------------------------------------------------------------------------------------------------------------------------------------------------------------------------------------------------f-
-----------------------------------T----------------------------------------T--------T---------T-T-----------------------T-T---------T--T----T----T----T---T----------T--------------------------------f-
-----T-----------------------------|----------------------------------T-----|--------|---------|-|--------------T-----T--|-|---------|--|----|----|--T-|---|----------|---T-----------------T----------f-
m----|-----------------------------|--------E-------------------------|-----|--------|-E-------|-|--------E-----|-----|--|-|---------|--|----|----|--|-|E--|----------|---|-----E-----------|------------
XXXXXXXXXXXXXXXXXXXXX--XXXXXXXXXXXXXXXXXXXXXXXXXXXXXXXXXXXXXXXXXXXXXXXXXXXXXXXXXXXXXXXXXXXXXXXXXXXXXX--XXXXXXXXXXXXXXXXXXXXXXXXXXXX--XXXXXXXX--XXXXXXXXXXXXXXXXXX--XXXXXXXXXXXXXXXXXX--XXXXXXXXXXXXXXXXX-
