---------------------------------------------------------------------------------------------------------------------------------------------------------------------------------------------------------
---------------------------------------------------------------------------------------------------------------------------------------------------------------------------------------------------------
---------------------------------------------------------------------------------------------------------------------------------------------------------------------------------------------------------
---------------------------------------------------------------------------------------------------------------------------------------------------------------------------------------------------------
---------------------------------------------------------------------------------------------------------------------------------------------------------------------------------------------------------
-------------------------------------?--------------------o-------------B-----------------------B-----------o-----?-------------------B-------------------o------B---------------------------------------
-----------------o----------B-B---------------------------------------?-----------------------------------------------------------------------BBB--B-------------------?B--------------------------------
---B------------B----------------------B---?------------------?-------------------------------B?B----------------------------------------B----------------------------------------------------------B--v-
-----------------------?-----------------B?B---B------------------------------B?B--------------------------------------?-----------B?B----------?-----------------------------?------------B?B---------f-
-------------------?-------------o---------------------B------B----------B-------------o--------------B-----------------------------------------------------------------------o----?-------------------f-
----------------------------------------------o--o----------------?---------------------------?-------o--------------B---------B??---?------B----------------------------------------------------------f-
----------------------------------------------------------------------------------------------------o-------------------------------o---------o--------------------------------------------------------f-
-------------T-------o-o--------T-----T----------T------------------T--T-----------T-----------------------T---------o---T--T-T---------------T---------------------------T----------------------------f-
-T-----------|------------T-----|-----|------oT--|----T-------------|--|-----------|-------------------o---|-----T-T---T-|--|-|--o--------o--o|------------T--------------|--o-------------------------f-
m|E----------|----------E-|-----|--E--|-------|--|---E|-------------|--|---------E-|-----------------------|-----|-|---|-|--|-|---------------|----E------E|E------E------|------E---------------E-------
XXXXXXXXXXX--XXXXXXXX--XXXXXXXX--XXXXXXXXXXXXXXXXXX--XXXXXXXXXXXXXXXXXX--XXXXXXXXXXXXXXXXXXXXXXXXXXXXXXXXXXXXXXXXXXXXXXXXXXXXXXXXXX--XXXXXXXXXXXXXXXXXX-XXXXXXXXXXXXXXXXXXXXXXXXXXXXXXXXXXXXXXXX-XXXXXXX-
