---------------------------------------------------------------------------------------------------------------------------------------------------------------------------------------------------------
---------------------------------------------------------------------------------------------------------------------------------------------------------------------------------------------------------
---------------------------------------------------------------------------------------------------------------------------------------------------------------------------------------------------------
---------------------------------------------------------------------------------------------------------------------------------------------------------------------------------------------------------
---------------------------------------------------------------------------------------------------------------------------------------------------------------------------------------------------------
-----------------------------------------------------B-------?-------------?------------------?----------B---------------------------------------------B-------------------------------------B-----------
----------o---------?---------------------------------------------------------o-------?-------------------------------------------------------------B---------o--B--------------------?------------------
-------------------------------?-BBB---------------B------------?BB------------------------------------------B---------?----------------------------------------------B---------------------B----------v-
-----------------------------------------------------------------------------------B-------------------------------------------------------------------------------------------------------------------f-
------------B--------------------------------------B?B---B----------?----------------------B--------------------------------------------------------------------------------------B------------------B-f-
---o---------------o----o---B------------o-B--o---------------------------------------------o--B--------------------?--------------------------------B---------Bo-----B??-------?----------------------f-
-------------------------------o---------o-------o---------------------------------------------------------------------------------------------------------------o----------o--------------------------f-
-------TTT---T------o--------To-----------T-T--o------T-------TT----------------T----T--o-----------------T-------------T------T-T---------T-T-T--------------------------------------o-------T--------f-
-----T-|||---|-----T------o--|T-----------|-|---T-----|---TT--||----------------|---T|---------------T----|-------------|------|-|--T--T-o-|-|-|------------------------------T---------------|--------f-
m----|-|||---|-----|---------||---------E-|-|---|-----|-E-||--||----------------|E--||-------E-------|----|-------------|------|-|--|-E|---|-|-|--------E-E-------------------|---------------|----------
XXXXXXXXXXXXXXXXXXXXXXXXXXXXXXXXXXXXXXXXXXXXXXXXXXX--XXXXXXXX--XXXXXXXXXXXXXXXXXX--XXXXXXXXXXXXXXXXXXXXXXXXXXXXXXXXXXXXXXXXXXXXXXXX--XXXXXXXXXXXXXXXXXX--XXXXXXXXXXXXXXXXXXXXXXXXXXXXXXXXXXXXXX--XXXXXXX-
