---------------------------------------------------------------------------------------------------------------------------------------------------------------------------------------------------------
---------------------------------------------------------------------------------------------------------------------------------------------------------------------------------------------------------
---------------------------------------------------------------------------------------------------------------------------------------------------------------------------------------------------------
---------------------------------------------------------------------------------------------------------------------------------------------------------------------------------------------------------
---------------------------------------------------------------------------------------------------------------------------------------------------------------------------------------------------------
--------------------------------------------------------------------------------------------------------------------B------------------------------------------------------------------------------------
-------------B-----------------------------------------------------------------------------o-------------------------------------------------------------------------------------------------------------
--------------------------------------------------------------------------------------------------------------------------------------------------------B----------------------------------------------v-
-?-----B-----------o---?--------M-----------?------?-----------------------o--------------------------------------------B-------------------------------------------------------o----------------------f-
---------------------------?-----------------------------------?----------------------------------------------------------------o----------------------------------------------------------------------f-
-------------------o-----------------------B-----------?--------------o----o------------------------------------------------------------------------B--------------------B----------------------o------f-
------TT------------------------------------------------o-------------------T------T----------------------------------------------------------o----------------------------------------o-----------o---f-
------||--------------------------------------------------------------------|------|-T----------------------------------------------------T-----T--T----------------T-T------o---------------------T---f-
------||----------------------T---T----o-------------T-----T----------------|------|-|-----------------------------------T----------T-----|-----|--|----------------|-|------T---------------------|---f-
m-----||----------------E-----|---|-------E----------|-----|-------E-----E--|------|-|-E------------E--------------------|----------|-E--E|-----|--|----------------|-|------|-------E-----E-------|-----
XXXXXXXXXXXXXXXXXXXXXXXXXXXXXXXXXXXXXXXXXXXXXXXXXXXXXXXXXXXXXXXXXXXXXXXXXXXXXXXXXXXXXXXXXXXXXXXXXXXXXXXXXXXXXXXXXXXXXXXXXXXXXXXXXXXXXXXXXXXXXXXXXXXXXXXXXXXXXXXXXXXXXXXXXXXXXXXXXXXXXXXXXXXXXXXXXXXXXXXX-
