--------------------------------------------------------------------------------------------------------------------------------------------------------------------------------------------------------
--------------------------------------------------------------------------------------------------------------------------------------------------------------------------------------------------------
--------------------------------------------------------------------------------------------------------------------------------------------------------------------------------------------------------
--------------------------------------------------------------------------------------------------------------------------------------------------------------------------------------------------------
--------------------------------------------------------------------------------------------------------------------------------------------------------------------------------------------------------
--B?B----B-------------------B--------------B-----B--------Bo----------------------------B---------------B--B---------B---------------------------------------------------------------------------------
-------------B-----------------B----------------------------------B------------------------------------------------------------B?B--------------------------B--------B?B---B-------o--------------------
-----------------------BB--------------------------------------------------------B?B------------------------------------------?-----------------B?B-------------?--------------B-----------------------v
--------------------------------------------------------------B-------------------B?B------------------------------------?-----------------------------------B-B------------o---------B-B----B---------f
-----------------------------------------------------------------------B------------------------------------------------------------------B------------------------------------------------------------f
-----B------B------------------B?B-BB----------------------------------------------------------------------------------------B-------------?-----------------------------B?B------o-B------------------f
-------------------------------------------------------------------------------------------------------------------------------------------------------------------------------------------------------f
---------------T--------------------------T----T---------T------------------T---------T--------T---T--------------------T--T---T----------------------------------TT-----------------------TT------T---f
---------------|----------T---------------|----|-T-------|-----T-T----T-----|---------|--------|---|-T------------------|--|---|----------------------------------||-----------------------||------|--Tf
m-------E------|----------|---------------|----|E|-------|-----|-|----|-----|----E----|--------|---|-|--------E-----E---|--|---|--------------------------E-------||-----------------------||------|--|-
XXXXXXXXXXXXXXXXXXXXXXXXXXXXXXXXXXXXXXXXXXXXXXXXXXXXXXXXXXXXX--XXXXXXXXXXXXXXXXXXXXXXXXXXXX--XXXXXXXXXXXXXXXXXXXXXXXXXXXXXXXXXXXXXX--XXXXXXXX--XXXXXXXXXXXXXXXXXXXXXXXXXXXXXXXXXXXXXXXXXXXXXXXX--XXXXXXX
