---------------------------------------------------------------------------------------------------------------------------------------------------------------------------------------------------------
---------------------------------------------------------------------------------------------------------------------------------------------------------------------------------------------------------
---------------------------------------------------------------------------------------------------------------------------------------------------------------------------------------------------------
---------------------------------------------------------------------------------------------------------------------------------------------------------------------------------------------------------
---------------------------------------------------------------------------------------------------------------------------------------------------------------------------------------------------------
-------------------------------------?--------------------o-------------B-----------------------B-----------o-----?-------------------B-------------------o------B---------------------------------------
-----------------o----------B-B---------------------------------------B-----------------------------------------------------------------------B?B--B-------------------?B--------------------------------
---B------------B----------------------B---?------------------?-------------------------------B?B----------------------------------------B----------------------------------------------------------B--v-
-----------------------?-----------------B?B---B------------------------------B?B--------------------------------------?-----------B?B----------B-----------------------------?------------B?B---------f-
-------------------?-------------o---------------------?------B----------B-------------o--------------B-----------------------------------------------------------------------o----?-------------------f-
------------o-----------------------------------------------------?---------------------------?----------------------B---------B??---?------B----------------------------------------------------------f-
---------------------------------------------------------------o---------------o----------------o-----------------------------o-----o------------------------------------------------------------------f-
-------------T-------o----------T-----T----------T------------------T--T-----------T-----------------------T---------o---T--T-T---------o-----T---------------------------T----------------------------f-
-T-----------|------------T-----|-o---|-------T--|----T-------------|--|-----------|-----------------------|-----T-T---T-|--|-|--o-----------o|------------T--------------|----------------------------f-
m|-----------|----------E-|-----|--E--|-------|--|---E|-------------|--|---------E-|-----------------------|-----|-|---|-|--|-|---------------|----E------E|E-------------|------E---------------E-------
XXXXXXXXXXX--XXXXXXXX--XXXXXXXX--XXXXXXXXXXXXXXXXXX--XXXXXXXXXXXXXXXXXX--XXXXXXXXXXXXXXXXXXXXXXXXXXXXXXXXXXXXXXXXXXXXXXXXXXXXXXXXXX--XXXXXXXXXXXXXXXXXX-XXXXXXXXXXXXXXXXXXXXXXXXXXXXXXXXXXXXXXXX-XXXXXXX-
